0000000000000000000000000000000000000000000000000000000000000000000000000000000000000000
0000000000000000000000000000000000000000000000000000000000000000000000222220000000000000
0000000000000000000000000000000000000000000000000000000000000000000000000000000000000000
0000000000000000000000000000000000000000000000000000000000022222000000000000000000000000
0000000222220000000000000000000000000000000000000222000000000000000000000000000000000000
0000000000000000000000000000000000000000000000000000000000000000000000000000000000000000
2200000000000000022000000000000000000000000000000000002222000000000222222000020002222222
1122222222222222211220000000022200000220000000222222221111220000022111111000210021111111
1111111111111111111110000000011100001111000000111111111111110000011111111000110011111111
1111111111111111111110001100000000000000000000111111111111111000011111111000110011111111
1111111111111111111110000000000000000000000000111111111111111000111111111100110011111111
11111111111111111111100000000000000100000010000111111111111111000111111111100110011111111