00000000000000000000000000000000000000000000000000000000000000000000000000000000000000000000000000000000000000000000000000000000000000000000000000000000000000000400000
00000000000000000000000000000000000000000000000000000000000000000000000000000000000000000000000000000000000000000000000000000000000000000000000000000000000000006360000
00000000000000000000000000000000000000000000000000000000000000000000000000000000000000000000000000000000000000000000000000000000000000000000000000000000000000062226000
00000000000000000000000000000000000000000000000000000000000000000000000000000000000000000000000000600000000000000000000000000000000000000000000000000066000000011111000
00000000000000000000000000000000000000000000000000000000000000000000000000000000000000000000000002220000000000000000000000000000000000000000000000066222000000000000000
00000000000000000000000000000000000000000000000002222000000000050656500000000000000000000060000000100000000000000000000000000000000000000000000006622111000000000000000
00000000002220000000000000000000000000000000000000000000000000222222222200000000000000000222000000000000000050005000550500500000000000050050055002211111000000000000000
00000002220000000000000000000000000000000000022200000000000000011111110000000005500000000010000000000000002222222222222222222000000000022222222221111110000000000000000
00000000000000000000000000000000000000000500000000000000000000000000000000000222222200000000000000000000000111111111111111110000000000000111111111111100000000000000000
22005500065006602200000000000022000000022220000000000005000000000000000000000001111000000000000000000000000000000000000000000000000000000000000000000000000000000000000
11222222222222221100000666000000000000000110000000000222222000000000000000000000000000000000000000000000000000000000000000000000000000000000000000000000000000000000000
11111111111111111100002222220000006022000000000000000000000000000000000000000000000000000000000000000000000000000000000000000000000000000000000000000000000000000000000
11111111111111111100000111100000022200000000000000000000000000000000000000000000000000000000000000000000000000000000000000000000000000000000000000000000000000000000000
11111111111111111100000000000000000000000000000000000000000000000000000000000000000000000000000000000000000000000000000000000000000000000000000000000000000000000000000
11111111111111111100000000000000000000000000000000000000000000000000000000000000000000000000000000000000000000000000000000000000000000000000000000000000000000000000000
11111111111111111100000000000000000000000000000000000000000000000000000000000000000000000000000000000000000000000000000000000000000000000000000000000000000000000000000
00000000000000000000000000000000000000000000000000000000000000000000000000000000000000000000000000000000000000000000000000000000000000000000000000000000000000000000000
00000000000000000000000000000000000000000000000000000000000000000000000000000000000000000000000000000000000000000000000000000000000000000000000000000000000000000000000
00000000000000000000000000000000000000000000000000000000000000000000000000000000000000000000000000000000000000000000000000000000000000000000000000000000000000000000000
00000000000000000000000000000000000000000000000000000000000000000000000000000000000000000000000000000000000000000000000000000000000000000000000000000000000000000000000
